6 16
32 32
3
0 1 2 3 4 2 1 4 3 4 1 3 4 4 1 5 
6 2 4 3 7 1 4 4 3 1 4 3 7 1 4 5 
8 4 1 9 10 4 11 11 9 2 4 9 10 11 4 5 
0 4 10 3 5 4 4 5 0 11 7 5 2 7 12 5 
0 1 2 3 5 4 1 5 0 4 10 5 4 13 3 5 
0 7 4 3 5 4 4 5 14 4 4 4 13 4 3 5 
