176
24
0 0 0 0 0 0 0 0 0 0 0 0 0 0 0 0 0 0 0 0 0 0 0 0 0 0 0 0 0 0 0 0 0 0 0 0 0 0 0 0 0 0 0 0 0 0 0 0 0 0 0 0 0 0 0 0 0 0 0 0 0 0 0 0 0 0 0 0 0 0 0 0 0 0 0 0 0 0 0 0 0 0 0 0 0 0 0 0 0 0 0 0 0 0 0 0 0 0 0 0 0 0 0 0 0 0 0 0 0 0 0 0 0 0 0 0 0 0 0 0 0 0 0 0 0 0 0 0 0 0 0 0 0 0 0 0 0 0 0 0 0 0 0 0 0 0 0 0 0 0 0 0 0 0 0 0 0 0 0 0 0 0 0 0 0 0 0 0 0 0 0 0 0 0 0 0
1 2 3 4 5 6 1 2 1 2 3 4 5 6 1 2 1 2 3 4 7 8 1 2 1 2 3 4 5 6 1 2 9 10 3 4 5 6 9 10 1 2 1 2 1 2 1 2 3 4 5 6 11 11 3 4 12 13 1 2 1 2 9 10 3 4 9 10 3 4 9 10 3 4 9 10 3 4 1 2 9 10 1 2 12 13 12 13 1 2 11 11 3 4 14 15 16 17 17 17 17 17 3 4 17 17 17 17 17 17 17 17 18 19 17 17 18 19 17 17 17 17 17 17 17 17 20 20 1 2 1 2 3 4 12 13 1 2 3 4 9 10 1 2 3 4 5 6 21 22 23 24 1 2 25 26 3 4 23 24 1 2 25 26 3 4 23 24 1 2 7 8 9 10 14 27
28 29 3 4 30 31 32 33 34 35 3 4 30 31 32 33 34 35 3 4 7 36 32 33 34 35 3 4 30 31 32 33 28 29 3 4 30 31 11 11 34 35 34 35 34 35 34 35 3 4 37 38 11 11 3 4 34 35 34 35 34 35 28 29 3 4 11 11 3 4 11 11 3 4 11 11 3 4 34 35 11 11 34 35 34 35 34 35 34 35 11 11 3 4 17 0 0 17 17 39 17 17 3 19 17 17 40 17 40 17 40 17 3 19 17 39 3 4 17 17 17 17 40 17 40 17 17 0 34 35 28 29 3 4 34 35 34 35 3 4 11 11 34 35 3 4 30 31 28 29 34 35 41 42 43 44 3 4 45 46 41 42 43 44 3 4 45 46 41 42 7 36 11 11 47 15
12 13 3 4 48 49 9 10 1 2 3 4 48 49 9 10 1 2 3 4 5 6 9 10 1 2 3 4 48 49 9 10 12 13 3 4 48 49 11 11 1 2 1 2 1 2 1 2 3 4 50 51 11 11 3 4 1 2 1 2 1 2 12 13 3 4 11 11 3 4 11 11 3 4 11 11 3 4 1 2 11 11 1 2 1 2 1 2 1 2 11 11 3 4 17 0 0 17 52 53 17 17 18 19 17 17 17 17 17 17 17 17 18 19 52 53 3 4 17 17 17 17 17 17 17 17 17 0 1 2 12 13 3 4 1 2 1 2 3 4 11 11 1 2 3 4 48 49 12 13 1 2 3 4 25 26 3 4 23 24 3 4 25 26 3 4 23 24 3 4 5 6 11 11 14 15
34 35 3 4 37 38 11 11 34 35 3 4 30 31 11 11 34 35 3 4 30 31 11 11 34 35 3 4 30 31 11 11 34 35 3 4 30 31 11 11 34 35 34 35 54 55 56 57 58 59 60 61 62 62 62 62 63 64 65 66 34 35 34 35 3 4 11 11 3 4 11 11 3 4 11 11 3 4 32 33 11 11 34 35 54 55 56 57 62 62 60 61 58 59 17 0 0 17 17 17 17 17 58 59 17 17 17 17 67 68 67 68 3 4 67 68 3 4 17 17 17 39 17 17 17 17 17 0 60 61 62 62 62 62 63 64 65 66 3 4 11 11 34 35 3 4 37 38 34 35 34 35 3 4 34 35 3 4 34 35 3 4 34 35 3 4 32 33 3 4 37 38 11 11 17 0
1 2 3 4 50 51 11 11 1 2 3 4 48 49 11 11 1 2 3 4 48 49 11 11 1 2 3 4 48 49 11 11 1 2 3 4 48 49 11 11 1 2 1 2 69 56 70 20 20 20 20 20 20 20 20 20 20 71 72 73 1 2 1 2 3 4 11 11 3 4 11 11 3 4 11 11 3 4 9 10 11 11 1 2 69 56 70 20 20 20 20 20 20 20 20 20 20 20 20 20 20 20 20 20 17 17 17 17 0 74 0 74 3 4 0 74 3 4 17 17 52 53 20 20 20 20 20 20 20 20 20 20 20 20 20 71 72 73 3 4 11 11 1 2 3 4 50 51 1 2 1 2 3 4 1 2 3 4 1 2 3 4 1 2 3 4 9 10 3 4 50 51 11 11 17 0
34 35 3 4 34 35 11 11 34 35 3 4 37 38 11 11 32 33 3 4 30 31 11 11 34 35 3 4 37 38 11 11 34 35 3 4 30 31 11 11 54 55 56 57 75 76 77 78 3 4 34 35 28 29 3 4 79 80 71 81 60 61 62 62 3 4 11 11 3 4 11 11 3 4 11 11 3 4 28 29 11 11 54 55 82 70 77 78 34 35 34 35 41 42 47 15 16 17 67 68 67 68 3 4 17 17 62 83 17 17 67 68 84 85 84 85 20 20 17 17 62 83 17 17 17 39 86 87 7 36 34 35 41 42 79 80 71 81 62 62 60 61 62 62 62 62 63 64 65 66 34 35 3 4 34 35 3 4 34 35 3 4 34 35 3 4 28 29 3 4 54 55 56 57 17 0
1 2 3 4 1 2 11 11 1 2 3 4 50 51 11 11 9 10 3 4 48 49 11 11 1 2 3 4 50 51 11 11 1 2 3 4 48 49 11 11 69 56 70 20 20 20 88 89 3 4 1 2 12 13 3 4 21 22 20 20 20 20 20 0 3 4 11 11 3 4 11 11 3 4 11 11 3 4 12 13 11 11 69 56 70 90 88 89 1 2 1 2 3 4 14 15 16 17 0 74 0 74 3 4 20 20 20 91 92 93 0 74 85 85 85 85 41 42 20 20 20 91 92 93 52 53 86 87 5 6 1 2 3 4 21 22 20 20 20 20 20 20 20 20 20 20 20 71 72 73 1 2 3 4 1 2 3 4 1 2 3 4 1 2 3 4 12 13 3 4 69 56 70 20 20 20
34 35 3 4 34 35 11 11 32 33 3 4 34 35 11 11 28 29 3 4 37 38 11 11 34 35 3 4 34 35 11 11 28 29 3 4 37 38 54 55 82 76 77 78 32 33 34 35 3 4 34 35 34 35 3 4 34 35 3 4 32 33 32 33 3 4 11 11 3 4 11 11 3 4 11 11 3 4 32 33 54 55 82 70 77 78 32 33 34 35 34 35 3 4 47 15 16 17 17 17 17 17 3 19 67 68 3 4 71 83 17 17 94 85 84 85 3 19 67 68 3 4 71 83 17 17 86 87 37 38 34 35 3 4 34 35 32 33 3 4 28 29 3 4 28 29 79 80 71 72 65 66 3 4 34 35 3 4 34 35 3 4 34 35 3 4 34 35 3 4 75 70 77 78 47 15
1 2 3 4 1 2 11 11 9 10 3 4 1 2 11 11 12 13 3 4 50 51 11 11 1 2 3 4 1 2 11 11 12 13 3 4 50 51 69 56 70 90 88 89 9 10 1 2 3 4 1 2 1 2 3 4 1 2 3 4 9 10 9 10 3 4 11 11 3 4 11 11 3 4 11 11 3 4 9 10 69 56 70 90 88 89 9 10 1 2 1 2 3 4 14 15 16 17 17 17 17 17 18 19 0 74 3 4 95 71 92 93 0 96 97 85 18 19 0 74 3 4 95 71 92 93 86 87 50 51 1 2 3 4 1 2 9 10 3 4 12 13 3 4 12 13 21 22 98 71 72 73 3 4 1 2 3 4 1 2 3 4 1 2 3 4 1 2 3 4 20 0 88 89 14 15
60 61 58 59 60 61 60 61 60 61 58 59 60 61 60 61 60 61 58 59 60 61 60 61 60 61 58 59 60 61 60 61 60 61 58 59 60 61 75 70 60 61 60 61 60 61 60 61 58 59 60 61 60 61 58 59 60 61 58 59 60 61 60 61 58 59 60 61 58 59 60 61 58 59 60 61 58 59 60 61 75 70 60 61 60 61 60 61 60 61 60 61 58 59 99 15 16 17 62 83 17 17 58 59 17 17 58 59 17 100 71 101 0 96 102 85 58 59 62 83 58 59 17 100 71 101 103 87 60 61 60 61 58 59 60 61 60 61 58 59 60 61 58 59 60 61 60 61 60 61 71 81 58 59 60 61 58 59 60 61 58 59 60 61 58 59 60 61 58 59 60 61 60 61 99 15
20 20 20 20 20 20 20 20 20 20 20 20 20 20 20 20 20 20 20 20 20 20 20 20 20 20 20 20 20 20 20 20 20 20 20 20 20 20 20 20 20 20 20 20 20 20 20 20 20 20 20 20 20 20 20 20 20 20 20 20 20 20 20 20 20 20 20 20 20 20 20 20 20 20 20 20 20 20 20 20 20 20 20 20 20 20 20 20 20 20 20 20 20 20 20 20 20 20 20 104 20 20 20 20 20 20 20 20 20 20 20 20 85 105 85 85 20 20 20 91 20 20 20 20 20 20 20 20 20 20 20 20 20 20 20 20 20 20 20 20 20 20 20 20 20 20 20 20 20 20 20 20 20 20 20 20 20 20 20 20 20 20 20 20 20 20 20 20 20 20 20 20 20 20 20 20
0 0 0 0 0 0 0 0 0 0 0 0 0 0 0 0 0 0 0 0 0 0 0 0 0 0 0 0 0 0 0 0 0 0 0 0 0 0 0 0 0 0 0 0 0 0 0 0 0 0 0 0 0 0 0 0 0 0 0 0 0 0 0 0 0 0 0 0 0 0 0 0 0 0 0 0 0 0 0 0 0 0 0 0 0 0 0 0 0 0 0 0 0 0 0 0 0 0 0 0 0 0 0 0 0 0 0 0 0 0 0 0 0 0 0 0 0 0 0 0 0 0 0 0 0 0 0 0 0 0 0 0 0 0 0 0 0 0 0 0 0 0 0 0 0 0 0 0 0 0 0 0 0 0 0 0 0 0 0 0 0 0 0 0 0 0 0 0 0 0 0 0 0 0 0 0
0 0 0 0 0 0 0 0 0 0 0 0 0 0 0 0 0 0 0 0 0 0 0 0 0 0 0 0 0 0 0 0 0 0 0 0 0 0 0 0 0 0 0 0 0 0 0 0 0 0 0 0 0 0 0 0 0 0 0 0 0 0 0 0 0 0 0 0 0 0 0 0 0 0 0 0 0 0 0 0 0 0 0 0 0 0 0 0 0 0 0 0 0 0 0 0 41 42 17 106 107 0 41 42 0 0 0 0 41 42 0 0 41 42 0 0 3 4 17 106 107 0 0 0 3 4 86 87 0 0 0 0 0 0 0 0 0 0 0 0 0 0 0 0 0 0 0 0 0 0 0 0 0 0 0 0 0 0 0 0 0 0 0 0 0 0 0 0 0 0 0 0 0 0 0 0
0 0 0 0 0 0 0 0 0 0 0 0 0 0 0 0 0 0 0 0 0 0 0 0 0 0 0 0 0 0 0 0 0 0 0 0 0 0 0 0 0 0 0 0 0 0 0 0 0 0 0 0 0 0 0 0 0 0 0 0 0 0 0 0 0 0 0 0 0 0 0 0 0 0 0 0 0 0 0 0 0 0 0 0 0 0 0 0 0 0 0 0 0 0 0 0 3 4 17 17 106 107 3 19 0 0 0 0 3 19 0 0 3 4 0 0 3 4 17 17 106 107 0 0 3 4 86 87 0 0 0 0 0 0 0 0 0 0 0 0 0 0 0 0 0 0 0 0 0 0 0 0 0 0 0 0 0 0 0 0 0 0 0 0 0 0 0 0 0 0 0 0 0 0 0 0
0 0 0 0 0 0 0 0 0 0 0 0 0 0 0 0 0 0 0 0 0 0 0 0 0 0 0 0 0 0 0 0 0 0 0 0 0 0 0 0 0 0 0 0 0 0 0 0 0 0 0 0 0 0 0 0 0 0 0 0 0 0 0 0 0 0 0 0 0 0 0 0 0 0 0 0 0 0 0 0 0 0 0 0 0 0 0 0 0 0 0 0 0 0 0 0 3 4 17 17 17 106 18 19 0 0 0 0 18 19 0 0 3 4 0 0 3 4 17 17 17 108 107 0 3 4 86 87 0 0 0 0 0 0 0 0 0 0 0 0 0 0 0 0 0 0 0 0 0 0 0 0 0 0 0 0 0 0 0 0 0 0 0 0 0 0 0 0 0 0 0 0 0 0 0 0
0 0 0 0 0 0 0 0 0 0 0 0 0 0 0 0 0 0 0 0 0 0 0 0 0 0 0 0 0 0 0 0 0 0 0 0 0 0 0 0 0 0 0 0 0 0 0 0 0 0 0 0 0 0 0 0 0 0 0 0 0 0 0 0 0 0 0 0 0 0 0 0 0 0 0 0 0 0 0 0 0 0 0 0 0 0 0 0 0 0 0 0 0 0 0 0 3 19 17 17 17 17 20 20 0 0 0 0 3 19 0 0 3 4 0 0 3 4 17 17 17 17 106 107 3 4 86 87 0 0 0 0 0 0 0 0 0 0 0 0 0 0 0 0 0 0 0 0 0 0 0 0 0 0 0 0 0 0 0 0 0 0 0 0 0 0 0 0 0 0 0 0 0 0 0 0
0 0 0 0 0 0 0 0 0 0 0 0 0 0 0 0 0 0 0 0 0 0 0 0 0 0 0 0 0 0 0 0 0 0 0 0 0 0 0 0 0 0 0 0 0 0 0 0 0 0 0 0 0 0 0 0 0 0 0 0 0 0 0 0 0 0 0 0 0 0 0 0 0 0 0 0 0 0 0 0 0 0 0 0 0 0 0 0 0 0 0 0 0 0 0 0 18 19 17 17 17 17 41 109 0 0 0 0 18 19 0 0 3 4 0 0 3 4 17 17 17 17 17 106 3 4 86 87 0 0 0 0 0 0 0 0 0 0 0 0 0 0 0 0 0 0 0 0 0 0 0 0 0 0 0 0 0 0 0 0 0 0 0 0 0 0 0 0 0 0 0 0 0 0 0 0
0 0 0 0 0 0 0 0 0 0 0 0 0 0 0 0 0 0 0 0 0 0 0 0 0 0 0 0 0 0 0 0 0 0 0 0 0 0 0 0 0 0 0 0 0 0 0 0 0 0 0 0 0 0 0 0 0 0 0 0 0 0 0 0 0 0 0 0 0 0 0 0 0 0 0 0 0 0 0 0 0 0 0 0 0 0 0 0 0 0 0 0 0 0 0 0 20 20 20 20 20 20 20 20 20 20 20 20 20 20 0 0 20 20 0 0 20 20 20 20 20 20 20 20 20 110 86 87 0 0 0 0 0 0 0 0 0 0 0 0 0 0 0 0 0 0 0 0 0 0 0 0 0 0 0 0 0 0 0 0 0 0 0 0 0 0 0 0 0 0 0 0 0 0 0 0
0 0 0 0 0 0 0 0 0 0 0 0 0 0 0 0 0 0 0 0 0 0 0 0 0 0 0 0 0 0 0 0 0 0 0 0 0 0 0 0 0 0 0 0 0 0 0 0 0 0 0 0 0 0 0 0 0 0 0 0 0 0 0 0 0 0 0 0 0 0 0 0 0 0 0 0 0 0 0 0 0 0 0 0 0 0 0 0 0 0 0 0 0 0 0 0 41 42 111 112 111 112 41 42 113 114 111 112 41 42 0 0 41 42 0 0 41 42 111 112 111 112 111 112 41 115 86 87 0 0 0 0 0 0 0 0 0 0 0 0 0 0 0 0 0 0 0 0 0 0 0 0 0 0 0 0 0 0 0 0 0 0 0 0 0 0 0 0 0 0 0 0 0 0 0 0
0 0 0 0 0 0 0 0 0 0 0 0 0 0 0 0 0 0 0 0 0 0 0 0 0 0 0 0 0 0 0 0 0 0 0 0 0 0 0 0 0 0 0 0 0 0 0 0 0 0 0 0 0 0 0 0 0 0 0 0 0 0 0 0 0 0 0 0 0 0 0 0 0 0 0 0 0 0 0 0 0 0 0 0 0 0 0 0 0 0 0 0 0 0 0 0 3 19 0 0 0 0 3 19 116 117 118 118 3 4 0 119 3 4 0 119 3 4 118 118 0 119 0 0 3 4 20 20 0 0 0 0 0 0 0 0 0 0 0 0 0 0 0 0 0 0 0 0 0 0 0 0 0 0 0 0 0 0 0 0 0 0 0 0 0 0 0 0 0 0 0 0 0 0 0 0
0 0 0 0 0 0 0 0 0 0 0 0 0 0 0 0 0 0 0 0 0 0 0 0 0 0 0 0 0 0 0 0 0 0 0 0 0 0 0 0 0 0 0 0 0 0 0 0 0 0 0 0 0 0 0 0 0 0 0 0 0 0 0 0 0 0 0 0 0 0 0 0 0 0 0 0 0 0 0 0 0 0 0 0 0 0 0 0 0 0 0 0 0 0 0 0 18 19 0 0 0 0 18 19 0 0 118 118 3 4 120 121 3 4 120 121 3 4 118 118 120 121 0 0 3 4 111 112 0 0 0 0 0 0 0 0 0 0 0 0 0 0 0 0 0 0 0 0 0 0 0 0 0 0 0 0 0 0 0 0 0 0 0 0 0 0 0 0 0 0 0 0 0 0 0 0
0 0 0 0 0 0 0 0 0 0 0 0 0 0 0 0 0 0 0 0 0 0 0 0 0 0 0 0 0 0 0 0 0 0 0 0 0 0 0 0 0 0 0 0 0 0 0 0 0 0 0 0 0 0 0 0 0 0 0 0 0 0 0 0 0 0 0 0 0 0 0 0 0 0 0 0 0 0 0 0 0 0 0 0 0 0 0 0 0 0 0 0 0 0 0 0 122 123 122 123 122 123 122 123 122 123 122 123 122 123 122 123 122 123 122 123 122 123 122 123 122 123 122 123 20 20 122 123 0 0 0 0 0 0 0 0 0 0 0 0 0 0 0 0 0 0 0 0 0 0 0 0 0 0 0 0 0 0 0 0 0 0 0 0 0 0 0 0 0 0 0 0 0 0 0 0
0 0 0 0 0 0 0 0 0 0 0 0 0 0 0 0 0 0 0 0 0 0 0 0 0 0 0 0 0 0 0 0 0 0 0 0 0 0 0 0 0 0 0 0 0 0 0 0 0 0 0 0 0 0 0 0 0 0 0 0 0 0 0 0 0 0 0 0 0 0 0 0 0 0 0 0 0 0 0 0 0 0 0 0 0 0 0 0 0 0 0 0 0 0 0 0 124 125 124 125 124 125 124 125 124 125 124 125 124 125 124 125 124 125 124 125 124 125 124 125 124 125 124 125 41 42 124 125 0 0 0 0 0 0 0 0 0 0 0 0 0 0 0 0 0 0 0 0 0 0 0 0 0 0 0 0 0 0 0 0 0 0 0 0 0 0 0 0 0 0 0 0 0 0 0 0