[SETTINGS]
#cell_size	num_x_cells	num_y_cells
128 6 2
[OBJECTS]
#index_x	index_y	object_id_1	object_id_2... 	object_id_n
0 0 1 3 15 20 27 28 29 30 31 32 33 34
0 1 3 21 27 28 29 30 31 32 33 34
1 0 2 4 16 22 27 28 29 30 31 32 33 34
1 1 21 22 27 28 29 30 31 32 33 34
2 0 6 7 22 27 28 29 30 31 32 33 34
2 1 5 8 21 22 27 28 29 30 31 32 33 34
3 0 27 28 29 30 31 32 33 34
3 1 9 10 21 27 28 29 30 31 32 33 34
4 0 11 19 27 28 29 30 31 32 33 34
4 1 11 12 21 27 28 29 30 31 32 33 34
5 0 13 14 17 24 26 27 28 29 30 31 32 33 34
5 1 13 14 18 21 23 24 25 27 28 29 30 31 32 33 34
END
