6 24
32 32
5
0 0 1 2 0 1 3 0 1 4 5 6 0 7 1 6 0 7 1 6 0 8 3 9 
0 2 10 0 0 10 11 0 10 12 2 0 1 7 10 6 1 7 10 6 1 4 11 9 
13 14 14 15 16 10 11 0 10 17 0 0 10 0 10 0 10 0 10 3 10 17 11 18 
4 0 1 5 19 14 13 14 14 15 16 0 10 0 10 0 10 0 10 2 10 20 21 22 
17 0 10 0 3 10 2 10 2 5 23 16 10 0 10 0 10 0 10 0 10 24 25 9 
13 13 26 13 13 26 13 26 13 13 13 19 26 13 26 13 26 13 26 13 26 13 13 27 
