[SETTINGS]
#cell_size	num_x_cells	num_y_cells
128 6 2
[OBJECTS]
#index_x	index_y	object_id_1	object_id_2... 	object_id_n
0 0 1 3 12 38 39 40 41 44
0 1 2 10 11 12 38 39 40 43 41 44
1 0 1 13 15 38 39 40 41 44
1 1 13 14 27 38 39 40 41 44
2 0 15 37 38 39 40 41 44
2 1 14 16 28 29 37 38 39 40 41 44
3 0 5 6 7 18 30 39 38 39 40 41 44
3 1 4 16 17 18 19 20 31 38 39 40 41 44
4 0 8 18 21 38 39 40 41 44
4 1 9 18 20 22 32 33 38 39 40 41 44
5 0 24 26 35 36 38 39 40 41 42 44
5 1 9 22 23 24 25 34 36 38 39 40 41 44
END
