6 24
32 32
4
0 1 2 2 1 3 3 3 3 3 3 3 3 3 3 3 3 3 3 3 3 3 3 0 
0 2 2 4 2 3 3 3 5 5 3 3 3 3 6 3 3 3 3 3 7 5 5 0 
0 2 2 1 2 3 3 6 8 9 6 3 3 3 10 5 5 5 5 11 12 4 2 13 
0 2 4 10 0 3 9 14 15 3 2 6 6 5 16 17 2 18 19 1 4 2 17 20 
0 2 10 2 2 11 11 4 1 1 2 2 10 18 1 6 2 8 9 19 2 17 1 0 
0 0 21 4 4 14 18 18 18 14 6 18 2 15 18 17 17 15 6 18 18 2 2 0 
