6 24
32 32
5
0 1 1 1 1 1 2 2 0 1 1 1 1 1 2 2 2 2 2 2 3 4 4 5 
6 7 6 6 6 6 1 1 6 7 6 6 6 6 1 1 1 1 8 8 9 10 11 12 
7 13 7 7 7 7 7 7 7 13 7 7 7 7 7 7 7 7 13 13 14 15 11 5 
16 17 13 16 16 13 16 13 16 17 13 16 16 13 16 13 13 13 17 18 14 19 20 21 
22 23 24 22 22 24 22 24 22 23 24 22 22 24 22 24 24 25 23 26 27 28 29 30 
31 31 31 31 31 31 31 31 31 31 31 31 31 31 31 31 31 31 31 31 31 31 31 31 
