[SETTINGS]
#cell_size	num_x_cells	num_y_cells
128 6 2
[OBJECTS]
#index_x	index_y	object_id_1	object_id_2... 	object_id_n
0 0 17 20 21 23 24 25 26 27 28
0 1 10 15 16 20 23 24 25 26
1 0 11 12 17 26 23 24 25 26
1 1 9 14 15 23 24 25 26
2 0 23 24 25 26
2 1 7 8 14 18 23 24 25 26
3 0 23 24 25 26
3 1 5 6 14 19 23 24 25 26
4 0 23 24 25 26
4 1 3 4 14 23 24 25 26
5 0 22 23 24 25 26
5 1 1 2 13 14 23 24 25 26
END
