12 48
16 16
7
0 0 0 0 1 2 3 3 4 5 3 3 6 7 8 9 0 0 0 0 0 0 0 0 0 0 0 0 0 0 0 0 0 0 0 0 0 0 0 0 0 0 0 0 10 11 12 13 
0 0 14 15 16 1 3 3 17 18 3 3 6 7 19 20 14 15 14 15 14 15 14 15 3 3 3 3 14 15 3 3 14 15 14 15 3 3 14 15 3 3 14 15 21 22 12 13 
0 0 15 23 3 3 1 2 3 3 3 3 6 7 24 25 15 23 10 11 26 27 15 23 4 5 10 11 26 27 8 9 15 23 10 11 26 27 4 5 10 11 26 27 28 29 12 13 
0 0 30 15 3 3 16 1 3 3 3 3 6 7 31 32 30 15 21 22 22 33 30 15 17 18 21 22 22 33 19 20 30 15 21 22 22 33 17 18 21 22 22 33 34 35 12 13 
0 0 3 3 3 3 3 3 1 2 4 5 6 7 15 23 4 5 22 22 22 22 4 5 15 23 36 22 37 38 24 25 3 3 36 22 22 22 15 23 22 22 22 22 15 23 12 13 
0 0 3 3 3 3 3 3 16 1 17 18 6 7 30 15 17 18 39 40 41 38 17 18 30 15 42 22 43 43 31 32 3 3 42 22 44 22 30 15 39 40 41 38 30 15 12 13 
0 0 4 5 3 3 0 0 0 0 0 0 6 7 28 29 15 23 28 29 37 38 15 23 4 5 45 22 43 43 15 23 3 3 45 22 45 22 4 5 22 22 43 43 3 3 0 0 
0 0 17 18 3 3 14 15 14 15 14 15 6 7 34 35 30 15 34 35 43 43 30 15 17 18 46 22 43 43 30 15 3 3 46 22 46 22 17 18 39 40 43 43 3 3 43 47 
0 0 0 0 3 3 4 5 3 3 15 23 6 7 15 23 4 5 0 0 15 23 3 3 3 3 0 0 15 23 4 5 3 3 15 23 15 23 15 23 15 23 3 3 3 3 43 48 
0 0 14 15 3 3 17 18 3 3 30 15 6 7 30 15 17 18 14 15 30 15 3 3 3 3 14 15 30 15 17 18 3 3 30 15 30 15 30 15 30 15 3 3 3 3 43 49 
0 0 3 3 0 0 0 0 3 3 3 3 6 7 3 3 3 3 3 3 3 3 3 3 3 3 3 3 3 3 3 3 3 3 3 3 3 3 3 3 3 3 0 0 0 0 0 0 
0 0 3 3 14 15 14 15 0 0 0 0 0 0 0 0 0 0 0 0 0 0 0 0 0 0 0 0 0 0 0 0 0 0 0 0 0 0 0 0 0 0 0 0 0 0 0 0 
