6 8
32 32
3
0 1 2 2 3 4 1 5 
0 1 2 3 2 6 1 5 
5 7 8 9 10 2 1 5 
5 1 6 2 2 11 7 5 
12 1 2 2 3 2 4 5 
13 7 9 8 10 10 9 5 
